# Resources from graph.properties

# common
alreadyUsed=사용여부


# tableAttr
attrName=속성명
preview=미리보기


# tableLayout
tblGrpFgNormal=일반
tblGrpFgTogo=포장
tblGrpFgDelivery=배달
floorName=그룹명
tblGrpFg=그룹 구분
del=삭제
background=홀

ts2=2인사각테이블
ts4=4인사각테이블


# touchkey
prodCd=상품코드
prodNm=상품명
prodClassNm=상품분류
all=전체
groupName=그룹명


# msg
errorOpeningFile=기존설정 조회 중 오류가 발생하였습니다.
cannotOpenFile=설정 파일을 열 수 없습니다.
invalidOrMissingFile=기존 설정 정보가 잘못되었습니다.
fileNotFound=파일을 찾을 수 없습니다.
saved=저장 되었습니다.
errorSavingFile=저장 중 오류가 발생하였습니다.
opened=저장된 설정으로 조회 되었습니다.
drawingTooLarge=요소가 너무 많습니다.

