# Resources from graph.properties
groupName=그룹명
prodNm=상품명
prodCd=상품코드
labelFunction=설정
fillCellColor=채우기
cancel=취소
apply=적용
font=폰트
align=정렬
errorOpeningFile=기존설정 조회 중 오류가 발생하였습니다.
cannotOpenFile=설정 파일을 열 수 없습니다.
invalidOrMissingFile=기존 설정 정보가 잘못되었습니다.
fileNotFound=파일을 찾을 수 없습니다.
initBtn=초기화
saveBtn=저장
saved=저장 되었습니다.
errorSavingFile=저장 중 오류가 발생하였습니다.
opened=초기 설정으로 초기화 되었습니다.
cellAlign=테이블정렬
left=왼쪽
center=중심
right=오른쪽
removeFormat=초기화
top=상단
middle=중앙
bottom=하단
bold=굵게
italic=이탤릭
underline=밑줄
floorConfig=그룹설정
floorName=그룹명
tblGrpFg=그룹 구분
tblGrpFgNormal=일반
tblGrpFgTogo=포장
tblGrpFgDelivery=배달
background=홀
untitledLayer={1}층
cancelBtn=취소
applyBtn=적용
backgroundColor=배경색
backgroundImage=배경이미지
initBackgroundImage=배경삭제
ts2=사각2인테이블

no=No.
attrName=속성명
preview=미리보기
alreadyUsed=사용여부
fontFamily=종류
